peptide	type	canonical	annotation
HAAASFETL	in_frame	LLAASFETL	FCRLA_novel_exon
RLLGTEFQT	in_frame	RLLGTEFQV	SLC45A2_alt_5
KTWDQVPFSV	in_frame	"KTWGQYWQV,ITDQVPFSV"	PMEL_exon_skip
NLLAEIHGV	in_frame	"NLNVEYNIF,NRLAEIHGV"	DPYSL4_exon_skip
LLAEIHGV	in_frame	"LNVEYNIF,RLAEIHGV"	DPYSL4_exon_skip
SEWENGSGM	in_frame	None	PMP2_exon_skip
TLFPERREW	in_frame	None	EPCAM_exon_skip
DRVGGRRDL	in_frame	None	LY6G6D_alt_3
SEQDPENRAW	in_frame	SEQDPEKAWGA	PRAP1_alt_3
QAQLEVSVQY	in_frame	DADFDEVQY	EIF3B_alt_5
YLLENLRSL	frameshift	None	PRLR_alt_3
VTDGVSLLL	frameshift	None	ENAH_alt_3
SPSRPPSSL	frameshift	None	PLPP2_alt_3
SLAPLVHLV	frameshift	None	COL1A1_exon_skip
VPHTRPVSL	frameshift	None	LGALS17A_junction
FLYQDPENQAL	in_frame	FLYQAAHCVLA	RPP21_alt_3
VVSGATGAK	frameshift	None	CNPY2_alt_5
VWMRSPLSTF	frameshift	None	ANXA2_alt_5
GIKHASIAR	frameshift	None	LASP1_alt_5